0 1 1 1 1 1 1 1 1 1 1 1 1 1 2
7 8 8 8 8 8 8 8 8 8 8 8 8 8 3
7 8 8 8 8 8 8 8 8 8 8 8 8 8 3
7 8 8 8 8 8 8 8 8 8 8 8 8 8 3
7 8 8 8 8 8 8 8 8 8 8 8 8 8 3
7 8 8 8 8 8 8 8 8 8 8 8 8 8 3
7 8 8 8 8 8 8 8 8 8 8 8 8 8 3
7 8 8 8 8 8 8 8 8 8 8 8 8 8 3
6 5 5 5 5 5 5 5 5 5 5 5 5 5 4